##########
#........#
#.##..##.#
#.#....#.#
#........#
#........#
#.#....#.#
#.##..##.#
#........#
##########
\robot 1 1
\robot 1 8
\robot 8 1