###...##
#.....##
#.##...#
#.####.#
#....#.#
#.#..###
#.#....#
###...##
\robot 5 0
\robot 4 0